NO textuer/North.xpm
SO textuer/diana.xpm
WE textuer/spider.xpm
EA textuer/sani.xpm







F 123,100,255
C 225,30,300

11111
10001
10S01
10001
11111

