WE jojo.xpm
NO jojo1.xpm
SO spider.xpm
EA sani.xpm

C 2,  21  ,  112
F 9,41,21


111111111111111111111111111111111111111111111111111111111111111111111111111111111111111111111111111111111111111111111111111111111
1N0000000010000000000000000000000000000000000000000000000000000000000000000000000000000000000000000000000000000000000000000000001
100000000010000010000000000000000000000000000000000000000000000000000000000000000000000000000000000000000000000000000000000000001
100000000000000010000000000000000000000000000000000000000000000000000000000000000000000000000000000000000000000000000000000000001
100000000010000010000000000000000000000000000000000000000000000000000000000000000000000000000000000000000000000000000000000000001
100000000000000000000000000000000000000000000000000000000000000000000000000000000000000000000000000000000000000000000000000000001
100000000000000000000000000000000000000000100000000000100000000000000000000000000000000000000000000000000000000000000000000000001
100000000000000000000000000000000000000000100000000000100000000000000000000000000000000000000000000000000000000000000000000000001
100000000000000000000000000000000000000000100000000000100000000000000000000000000000000000000000000000000000000000000000000000001
100000000000000000000000000000000000000000100000000000100000000000000000000000000000000000000000000000000000000000000000000000001
100000000000000000000000000000000000000000100000000000100000000000000000000000000000000000000000000000000000000000000000000000001
100000000000000000000000000000000000000000100000000000100000000000000000000000000000000000000000000000000000000000000000000000001
100000000000000000000000000000000000000000100000000000100000000000000000000000000000000000000000000000000000000000000000000000001
100000000000000000000000000000000000000000100000000000100000000000000000000000000000000000000000000000000000000000000000000000001
100000000000000000000000000000000000000000101111111100100000000000000000000000000000000000000000000000000000000000000000000000001
100000000000000000000000000000000000000000100000000000100000000000000000000000000000000000000000000000000000000000000000000000001
100000000000000000000000000000000000000000100000000000100000000000000000000000000000000000000000000000000000000000000000000000001
100000000000000000000000000000000000000000100000000000100000000000000000000000000000000000000000000000000000000000000000000000001
100000000000000000000000000000000000000000100000000000100000000000000000000000000000000000000000000000000000000000000000000000001
100000000000000000000000000000000000000000100000000000100000000000000000000000000000000000000000000000000000000000000000000000001
100000000000000000000000000000000000000000100000000000100000000000000000000000000000000000000000000000000000000000000000000000001
100000000000000000000000000000000000000000100000000000100000000000000000000000000000000000000000000000000000000000000000000000001
100000000000000000000000000000000000000000100000000000100000000000000000000000000000000000000000000000000000000000000000000000001
100000000000000000000000000000000000000000100000000000100000000000000000000000000000000000000000000000000000000000000000000000001
100000000000000000000000000000000000000000100000000000100000000000000000000000000000000000000000000000000000000000000000000000001
100000000000000000000000000000000000000000000000000000000000000000000000000000000000000000000000000000000000000000000000000000001
100000000000000000000000000000000000000000000000000000000000000000000000000000000000000000000000000000000000000000000000000000001
100000000000000000000000000000000000000000000000000000000000000000000000000000000000000000000000000000000000000000000000000000001
100000000000000000000000000000000000000000000000000000000000000000000000000000000000000000000000000000000000000000000000000000001
100000000000000000000000000000000000000000000000000000000000000000000000000000000000000000000000000000000000000000000000000000001
100000000000000000000000000000000000000000000000000000000000000000000000000000000000000000000000000000000000000000000000000000001
100000000000000000000000000000000000000000000000000000000000000000000000000000000000000000000000000000000000000000000000000000001
100000000000000000000000000000000000000000000000000000000000000000000000000000000000000000000000000000000000000000000000000000001
100000000000000000000000000000000000000000000000000000000000000000000000000000000000000000000000000000000000000000000000000000001
100000000000000000000000000000000000000000000000000000000000000000000000000000000000000000000000000000000000000000000000000000001
100000000000000000000000000000000000000000000000000000000000000000000000000000000000000000000000000000000000000000000000000000001
100000000000000000000000000000000000000000000000000000000000000000000000000000000000000000000000000000000000000000000000000000001
100000000000000000000000000000000000000000000000000000000000000000000000000000000000000000000000000000000000000000000000000000001
100000000000000000000000000000000000000000000000000000000000000000000000000000000000000000000000000000000000000000000000000000001
111111111111111111111111111111111111111111111111111111111111111111111111111111111111111111111111111111111111111111111111111111111
